1
6 5
3 1 7 4 2
2 1 3 1 1
1 2 2 1 8
2 2 1 5 3
2 1 4 4 4
5 2 7 5 1
